AAAAAAAAAAAAAAAAAAAAAAAAAAAAAAAAAAAAAAAAAAAAAAAAAA
ABBBBBAAAAAAAAAAAAAAAAAAAAAAAAAAAAAAAAAAAAAABBBBBA
ABBBBBAAAAAAAAAAAAAAAAAAAAAAAAAAAAAAAAAAAAAABBBBBA
ABBBBBAAAAAAAAAAAAAAAAAAAAAAAAAAAAAAAAAAAAAABBBBBA
ABBBBBAAAAAAAAAAAAAAAAAAAAAAAAAAAAAAAAAAAAAABBBBBA
ABBBBBAAAAAAAAAAAAAAAAAAAAAAAAAAAAAAAAAAAAAABBBBBA
AAAAAAAAAAAAAAAAAAAAAAAAAAAAAAAAAAAAAAAAAAAAAAAAAA
AAAAAAAAAAAAAAAAAAAAAAAAAAAAAAAAAAAAAAAAAAAAAAAAAA
AAAAAAAAAAAAAAAAAAAAAAAAAAAAAAAAAAAAAAAAAAAAAAAAAA
AAAAAACCCCCCCCCCCCCCCCCCCCCCCCCCCCCCCCCCCCCCAAAAAA
AAAAAACCCCCCCCCCCCCCCCCCCCCCCCCCCCCCCCCCCCCCAAAAAA
AAAAAACCCCCCCCCCCCCCCCCCCCCCCCCCCCCCCCCCCCCCAAAAAA
AAAAAACCCCCCCCCCCCCCCCCCCCCCCCCCCCCCCCCCCCCCAAAAAA
AAAAAACCCCCCCCCCCCCCCCCCCCCCCCCCCCCCCCCCCCCCAAAAAA
AAAAAACCCCCCCCCCCCCCCCCCCCCCCCCCCCCCCCCCCCCCAAAAAA
AAAAAAAAAAAAAAAAAAAAAAAAAAAAAAAAAAAAAAAAAAAAAAAAAA
AAAAAAAAAAAAAAAAAAAAAAAAAAAAAAAAAAAAAAAAAAAAAAAAAA
AAAAAAAAAAAAAAAAAAAAAAAAAAAAAAAAAAAAAAAAAAAAAAAAAA
ABBBBBAAAAAAAAAAAAAAAAAAAAAAAAAAAAAAAAAAAAAABBBBBA
ABBBBBAAAAAAAAAAAAAAAAAAAAAAAAAAAAAAAAAAAAAABBBBBA
ABBBBBAAAAAAAAAAAAAAAAAAAAAAAAAAAAAAAAAAAAAABBBBBA
ABBBBBAAAAAAAAAAAAAAAAAAAAAAAAAAAAAAAAAAAAAABBBBBA
ABBBBBAAAAAAAAAAAAAAAAAAAAAAAAAAAAAAAAAAAAAABBBBBA
AAAAAAAAAAAAAAAAAAAAAAAAAAAAAAAAAAAAAAAAAAAAAAAAAA