AAAAAAAAAAAAAAAAAAAAAAAAAAAAAAAAAAAAAAAAAAAAAAAAAA
CCCCCCCCCCCCCCCCCCCCCCCCCCCCCCCCCCCCCCCCCCCCCCCCCA
AAAAAAAAAAAAAAAAAAAAAAAAAAAAAAAAAAAAAAAAAAAAAAAACA
ACCCCCCCCCCCCCCCCCCCCCCCCCCCCCCCCCCCCCCCCCCCCCCACA
ACAAAAAAAAAAAAAAAAAAAAAAAAAAAAAAAAAAAAAAAAAAAACACA
ACACCCCCCCCCCCCCCCCCCCCCCCCCCCCCCCCCCCCCCCCCCACACA
ACACAAAAAAAAAAAAAAAAAAAAAAAAAAAAAAAAAAAAAAAACACACA
ACACACCCCCCCCCCCCCCCCCCCCCCCCCCCCCCCCCCCCCCACACACA
ACACACAAAAAAAAAAAAAAAAAAAAAAAAAAAAAAAAAAAACACACACA
ACACACABBBBBBBBBBBBBBBBBBBBBBBBBBBBBBBBBBACACACACA
ACACACABBBBBBBBBBBBBBBBBBBBBBBBBBBBBBBBBBACACACACA
ACACACABBBBBBBBBBBBBBBBBBBBBBBBBBBBBBBBBBACACACACA
ACACACABBBBBBBBBBBBBBBBBBBBBBBBBBBBBBBBBBACACACACA
ACACACABBBBBBBBBBBBBBBBBBBBBBBBBBBBBBBBBBACACACACA
ACACACABBBBBBBBBBBBBBBBBBBBBBBBBBBBBBBBBBACACACACA
ACACACAAAAAAAAAAAAAAAAAAAAAAAAAAAAAAAAAAAACACACACA
ACACACACCCCCCCCCCCCCCCCCCCCCCCCCCCCCCCCCCCCACACACA
ACACACAAAAAAAAAAAAAAAAAAAAAAAAAAAAAAAAAAAAAACACACA
ACACACCCCCCCCCCCCCCCCCCCCCCCCCCCCCCCCCCCCCCCCACACA
ACACAAAAAAAAAAAAAAAAAAAAAAAAAAAAAAAAAAAAAAAAAACACA
ACACCCCCCCCCCCCCCCCCCCCCCCCCCCCCCCCCCCCCCCCCCCCACA
ACAAAAAAAAAAAAAAAAAAAAAAAAAAAAAAAAAAAAAAAAAAAAAACA
ACCCCCCCCCCCCCCCCCCCCCCCCCCCCCCCCCCCCCCCCCCCCCCCCA
AAAAAAAAAAAAAAAAAAAAAAAAAAAAAAAAAAAAAAAAAAAAAAAAAA