AAAAAAAAAAAAAAAAAAAAAAAAAAAAAAAAAAAAAAAAAAAAAAAAAA
ACACACACACACACACACACACACACACACACACACACACACACACACAA
ACCCCCCCCCCCCCCCCCCCCCCCCCCCCCCCCCCCCCCCCCCCCCCCCA
ACCCCCCCCCCCCCCCCCCCCCCCCCCCCCCCCCCCCCCCCCCCCCCCCA
ACCCCCCCCCCCCCCCCCCCCCCCCCCCCCCCCCCCCCCCCCCCCCCCCA
AACACACACACACACACACACACACACACACACACACACACACACACACA
AAAAAAAAAAAAAAAAAAAAAAAAAAAAAAAAAAAAAAAAAAAAAAAAAA
AAAAAAAAAAAAAAAAAAAAAAAAAAAAAAAAAAAAAAAAAAAAAAAAAA
AAABBBBBBBBBBBBBBBBBBBBAAAABBBBBBBBBBBBBBBBBBBBAAA
AAABBBBBBBBBBBBBBBBBBBBAAAABBBBBBBBBBBBBBBBBBBBAAA
AAABBBBBBBBBBBBBBBBBBBBAAAABBBBBBBBBBBBBBBBBBBBAAA
AAAAAAAAAAAAAAAAAAAAAAAAAAAAAAAAAAAAAAAAAAAAAAAAAA
AAAAAAAAAAAAAAAAAAAAAAAAAAAAAAAAAAAAAAAAAAAAAAAAAA
AAABBBBBBBBBBBBBBBBBBBBAAAABBBBBBBBBBBBBBBBBBBBAAA
AAABBBBBBBBBBBBBBBBBBBBAAAABBBBBBBBBBBBBBBBBBBBAAA
AAABBBBBBBBBBBBBBBBBBBBAAAABBBBBBBBBBBBBBBBBBBBAAA
AAAAAAAAAAAAAAAAAAAAAAAAAAAAAAAAAAAAAAAAAAAAAAAAAA
AAAAAAAAAAAAAAAAAAAAAAAAAAAAAAAAAAAAAAAAAAAAAAAAAA
AACACACACACACACACACACACACACACACACACACACACACACACACA
ACCCCCCCCCCCCCCCCCCCCCCCCCCCCCCCCCCCCCCCCCCCCCCCCA
ACCCCCCCCCCCCCCCCCCCCCCCCCCCCCCCCCCCCCCCCCCCCCCCCA
ACCCCCCCCCCCCCCCCCCCCCCCCCCCCCCCCCCCCCCCCCCCCCCCCA
ACACACACACACACACACACACACACACACACACACACACACACACACAA
AAAAAAAAAAAAAAAAAAAAAAAAAAAAAAAAAAAAAAAAAAAAAAAAAA